###########..#####........#########.............
#.........#..#...#........#.......#.............
#.........#..#...#........#.......#.........H...
#...............................................
#.#########..#...#........#.......#.............
.............#...#........#.......#.............
.............#...#........#.......#.............
.............#.###........#.......#.............
..........................#.......#.............
..........................#.#######.............
................................................
................................................
................................................
#.#########..#.####.......#.####................
#.................................J.............
#.........#..#....#.......#....#................
#.........#..#....#.......#....#................
#.........#..#....#.......#....#................
#.........#..#....#.......#.####................
#.........#..#....#.............................
#.........#..#.####.............................
#.........#.....................................
#.........#.....................................
#.........#.....................................
#.........#.....................................
#.........#.....................................
#.#########.....................................
................................................
................................................
................................................
................................................
................................................
...............................................A
