##################
#.........HS.....#
#....####........#
#..............###
#.A..............#
#........###.....#
#................#
##################